CCEEEEEEEE
ECEEEEEEEE
EECEEEEEEE
EECEEEEEEE
EEECEEEEEE
EEECCEEEEE
EEEEECEEEE
EEEEECCCEE
EEEEEEEECE
EEEEEEEEEE
