DEEEEWEEEE
EWEWEWEWEE
EEEEEEEEEE
WEEEEEEWEE
EEEEEEEWEE
EWEEEWEEEE
EEEEEWEEEE
EEEEEEEEEE
EEEEEEEEEE
EWEEEWEEEA
