EEEEWEEWEE
EEEWEWEEWE
EEEWEWEWWE
EEEEWEWEEE
WWWWWWWWEW
EEEEEEEEEE
EEEEEEWWWW
EWEEEWEEEE
EEWWEWECEE
EEEEEEEECE
