DEEEEWEEEE
EWEWEWEWEE
EEEEEWEEEE
WEEWEWEWEE
EEEEEWEWEE
EWEWEWEEEE
EEEWEWEEEE
EWEEEWEEEE
EEEEEWEEEE
EWEEEWEEEA
