ECCCCCECCCEEEEE
CWWWWWCWWWCCEEE
CWECCCWCECWWCCE
CWCWWWCWCWCCWWC
CWCWECWEWCWWCCC
CWCWEECCCWCCWWE
CWCWEEEWWEWWCCW
CWCWEWWEEWEEWWC
CWCWWEEEEWEEEWC
CWCCEEEEEEEEEWC
CWWWCCEEEEEEEWC
CWEEWWCCEEEEEWC
CWECEWWWCCEWWWC
CWCWCWECWWEWEWC
CWCWCWCWCWWCEWC
CWCWCWCWCWCWCWC
CWCWCWCWCWCWCWC
CWCWCWCWCWCWCWC
CWCWCWCWCWCWCWC
CWCWCWCWCWCWCWC
CWCWCWCWCWCWCWC
CWCWCWCWCWCWCWC
CWCWCWCWCWCWCWC
CCCWCCCWCCCWCCC
