EEEDEWEEEE
EWEWEWEWEE
EEEEEWEEEE
WEEWEWEWEE
EEEEEWEWEE
EWEWEWEEEE
EEEWEWEEEE
EWEAEWEEEE
EEEEEWEEEE
EWEEEWEEEE