EEEEEEEEEEEEEEE
EECEEWEWEWEEEEE
ECCWWEWEWEWWEEE
ECEWWWWEEEEWEWE
ECEEEEWWEEEWWEE
ECWWWWWWEWEEEWE
EECCEEEEEEEWWEE
EWEECCCCEWWEWEE
EWWWWWWCEEEWEEE
EEEEWWEECEWEEWE
EWEEWWWECWWEWEE
EEWEEWEECEWWEEE
EEEWWWEECCWEWWE
EEWEEEEEEECCWWW
EEEEEWEEEEWWCCE
EEWWWEEWEWWWEEE
EEEWWWWWWWEEEEE
EEEWEWWEWWWWWEE
EEEEWEWEEEWEEEE
EEEWWEEWWEEWEEE
EEEWEEEEEEEEEEE
EEEWEWEWWWWEEEE
EEEEWEWEEEEEEEE
EEEEEEEEEEEEEEE
