EEEEEEWEWWEWWWE
EEEEEWEWWEWWEEE
EEEWEEWEWWEWWWE
EWEEEECEEEWWEWE
EEEEWCCEWEEEEEW
EEWEECWEEEEEEEE
EEEWECEEWEEEEWE
WEEEECEEEEWWEEE
EEEECEEEEEEEWWE
EEECCEEEEEEEEEE
EEECEEEEEEEEEEE
EECEEEEEEEEEEEW
ECCEWEEEEEEEEEW
CEEWEEEEEEEEEEE
CEEEEEEEEEEWWWE
CEEEEEEEEWEEEWE
EEEEEEEEWEEEEEW
EEEWEEEEEEEWEWE
EWWEWEEEEEEEWWE
EEEWWWEEEWWWEEW
EEWEEEWEWWEEEEW
EEEEWWWEEEEEEWE
EEEEEEWEWEEWEEW
EEEEEEEEEEWWEWE
